"Redback"
10
50 40 60 80 90 94 99
1.0
music/pip-tantrumsgalore.it
sounds/click.ogg
sounds/touch.ogg
sounds/bomb.ogg
4
images/background.png
images/brick_dkgrey.svg
images/brick_black.svg
images/brick_red.svg
01010101010101010101010101010101010101010101010101010101010101010101
01010000000000000000000000000000000000000000000000000000000000000101
01010000000000000000000000000000000000000000000000000000000000000101
01010000000000000200000000000000000000000200000000000000000000000101
01010000000000000000020000000000000002000000000000000000000000000101
01010000000000000000000002000000020000000000020002000200020020000101
01010000020002000000000002000000020000000200000000000000000000000101
01010000000000000200000002000200020002000000000002000200000000000101
01010000000000000100020002000200020002000200020002000200020000000101
01010000000000000200020002000200020002000200030003000300030000000101
01010000000000000100020002000200020002000200020002000200020000000101
01010000000000000200000002000200020002000000000002000200000000000101
01010000020002000000000002000000020000000200000000000000000000000101
01010000000000000000000002000000020000000000020002000200020020000101
01010000000000000000020000000000000002000000000000000000000000000101
01010000000000000200000000000000000000000200000000000000000000000101
01010000000000000000000000000000000000000000000000000000000000000101
01010000000000000000000000000000000000000000000000000000000000000101
01010000000000000000000000000000000000000000000000000000000000000101
01010000000000000000000000000000000000000000000000000000000000000101
