Deadpool Rules
100
1.2
music/pip-theserpentswings.it
sounds/click.ogg
sounds/touch.ogg
sounds/bomb.ogg
8
images/background.png
images/brick_dkgrey.svg
images/brick_fixed.svg
images/brick_red.svg
images/brick_purple.svg
images/brick_orange.svg
images/brick_green.svg
images/brick_yellow.svg
01010101010101010101010101010101010101010101010101010101010101010101
01010000000000000000000000000000000000000000000000000000000000000101
01010000000000000000000000000300030003000000000000000000000000000101
01010000000000000000000003000000030000000300000000000000000000000101
01010000000000000000030000000000030000000000030000000000000000000101
01010000000000000300000000000000030000000000000003000000000000000101
01010000000000000300000002080000030000000208000003000000000000000101
01010000000000000300000002080000030000000208000003000000000000000101
01010000000000000300000000000000030000000000000003000000000000000101
01010000000000000000030000000000030000000000030000000000000000000101
01010000000000000000000003000000030000000300000000000000000000000101
01010000000000000000000000000300030003000000000000000000000000000101
01010000000000000000000000000000000000000000000000000000000000000101
01010000000000000000000000000000000000000000000000000000000000000101
01010000000000000000000000000000000000000000000000000000000000000101
01010000000000000000000000000000000000000000000000000000000000000101
01010000000000000000000000000000000000000000000000000000000000000101
01010000000000000000000000000000000000000000000000000000000000000101
01010000000000000000000000000000000000000000000000000000000000000101
01010000000000000000000000000000000000000000000000000000000000000101
