"Butterflies"
10
50 40 60 80 90 94 99
1.0
music/pip-awalkinthepark.it
sounds/click.ogg
sounds/touch.ogg
sounds/bomb.ogg
8
images/background.png
images/brick_dkgrey.svg
images/brick_blue.svg
images/brick_red.svg
images/brick_purple.svg
images/brick_orange.svg
images/brick_green.svg
images/brick_black.svg
01010101010101010101010101010101010101010101010101010101010101010101
01010000000000000000000000000000000000000000000000000000000000000101
01010000000000000000000000000000000000000000000000000000000000000101
01010000000000000000000000000100000001000000000000000000000000000101
01010000000000000000000000000100000001000000000000000000000000000101
01010000000000000000020002000000070300000200020000000000000000000101
01010000000000000200040004000200070302000400040002000000000000000101
01010000000000000200040006000400070304000600040002000000000000000101
01010000000000000200040004000400070304000400040002000000000000000101
01010000000000000000020004000400070304000400020000000000000000000101
01010000000000000200040004000400070304000400040002000000000000000101
01010000000000000200040004000400070304000400040002000000000000000101
01010000000000000200040006000400070304000600040002000000000000000101
01010000000000000200040004000200070302000400040002000000000000000101
01010000000000000000020002000000070300000200020000000000000000000101
01010000000000000000000000000000070300000000000000000000000000000101
01010000000000000000000000000000000000000000000000000000000000000101
01010000000000000000000000000000000000000000000000000000000000000101
01010000000000000000000000000000000000000000000000000000000000000101
01010000000000000000000000000000000000000000000000000000000000000101
