"Level Twelve"
10
50 40 60 80 90 94 99
1.0
music/pip-ruby.it
sounds/click.ogg
sounds/touch.ogg
sounds/bomb.ogg
4
images/background.png
images/brick_dkgrey.svg
images/brick_blue.svg
images/brick_ltgreen.svg
01010101010101010101010101010101010101010101010101010101010101010101
01010000000000000000000000000000000000000000000000000000000000000101
01010300000000000000000000000000000000000000000000000000000000000101
01010200030000000000000000000000000000000000000000000000000000000101
01010300020003000000000000000000000000000000000000000000000000000101
01010200030002000300000000000000000000000000000000000000000000000101
01010300020003000200030000000000000000000000000000000000000000000101
01010200030002000300020000000000000000000000000000000000000000000101
01010300020003000200030002000000000000000000000000000000000000000101
01010200030002000300020003000200000000000000000000000000000000000101
01010300020003000200030002000300020000000000000000000000000000000101
01010200030002000300020003000200030002000000000000000000000000000101
01010101010101010101010101010101010101010101000000000000000000000101
01010000000000000000000000000000000000000000000000000000000000000101
01010000000000000000000000000000000000000000000000000000000000000101
01010000000000000000000000000000000000000000000000000000000000000101
01010000000000000000000000000000000000000000000000000000000000000101
01010000000000000000000000000000000000000000000000000000000000000101
01010000000000000000000000000000000000000000000000000000000000000101
01010000000000000000000000000000000000000000000000000000000000000101
