Level Seven
10
1.0
music/pip-outofit.it
sounds/click.ogg
sounds/touch.ogg
sounds/bomb.ogg
8
images/background.png
images/brick_dkgrey.svg
images/brick_fixed.svg
images/brick_red.svg
images/brick_purple.svg
images/brick_orange.svg
images/brick_green.svg
images/brick_yellow.svg
01010101010101010101010101010101010101010101010101010101010101010101
01010000000000000000000000000000000000000000000000000000000000000101
01010000010102000200020002000200020002000200020002000200010100000101
01010000020000000000040004000000000000000400040000000000020000000101
01010000020000000000000000000000000000000000000000000000020000000101
01010000010102000200020002000200020002000200020002000200010100000101
01010000000000000300000000000000030000000000000003000000000000000101
01010000000000000000000000000000000000000000000000000000000000000101
01010000000000000000000000000000000000000000000000000000000000000101
01010000010102000200020002000200020002000200020002000200010100000101
01010000020000000000040004000000000000000400040000000000020000000101
01010000020000000000000000000000000000000000000000000000020000000101
01010000010102000200020002000200020002000200020002000200010100000101
01010000000000000300000000000000030000000000000003000000000000000101
01010000000003000000030000000300000003000000030000000300000000000101
01010000000003000000030000000300000003000000030000000300000000000101
01010000000000000000000000000000000000000000000000000000000000000101
01010000000000000000000000000000000000000000000000000000000000000101
01010000000000000000000000000000000000000000000000000000000000000101
01010000000000000000000000000000000000000000000000000000000000000101
