Level Four
10
1.0
music/pip-bulldogge.it
sounds/click.ogg
sounds/touch.ogg
sounds/bomb.ogg
8
images/background.png
images/brick_dkgrey.svg
images/brick_blue.svg
images/brick_red.svg
images/brick_purple.svg
images/brick_orange.svg
images/brick_green.svg
images/brick_yellow.svg
01010101010101010101010101010101010101010101010101010101010101010101
01010000000000000000000000000000000000000000000000000000000000000101
01010000000002000200020002000200020002000200020002000200000000000101
01010000000003000300030003000300030003000300030003000300000000000101
01010000000004000400040004000400040004000400040004000400000000000101
01010000000005000500050005000500050005000500050005000500000000000101
01010000000000000000000000000000000000000000000000000000000000000101
01010000000000000000000000000000000000000000000000000000000000000101
01010000000000000000000000000000000000000000000000000000000000000101
01010000000002000200020002000200020002000200020002000200000000000101
01010000000003000300030003000300030003000300030003000300000000000101
01010000000004000400040004000400040004000400040004000400000000000101
01010000000005000500050005000500050005000500050005000500000000000101
01010000000000000000000000000000000000000000000000000000000000000101
01010000000000000000000000000000000000000000000000000000000000000101
01010000000000000000000000000000000000000000000000000000000000000101
01010000000000000000000000000000000000000000000000000000000000000101
01010000000000000000000000000000000000000000000000000000000000000101
01010000000000000000000000000000000000000000000000000000000000000101
01010000000000000000000000000000000000000000000000000000000000000101
