"Level Seventeen"
10
50 40 60 80 90 94 99
1.0
music/pip-compaction.it
sounds/click.ogg
sounds/touch.ogg
sounds/bomb.ogg
8
images/background.png
images/brick_dkgrey.svg
images/brick_blue.svg
images/brick_red.svg
images/brick_purple.svg
images/brick_orange.svg
images/brick_green.svg
images/brick_yellow.svg
01010101010101010101010101010101010101010101010101010101010101010101
01010000000000000000000000000000000000000000000000000000000000000101
01010000020302000200020002000200020002000200020002000200020300000101
01010000038103000300030003000300030003000300030003000300038100000101
01010000040304000400040004000400040004000400040004000400040300000101
01010000058105000500050005000500050005000500050005000500058100000101
01010000000000000000000000000000000000000000000000000000000000000101
01010000000000000000000000000000000000000000000000000000000000000101
01010000020302000200020002000200020002000200020002000200020300000101
01010000038103000300030003000300030003000300030003000300038100000101
01010000040304000400040004000400040004000400040004000400040300000101
01010000058105000500050005000500050005000500050005000500058100000101
01010000000001010101010101010101010101010101010101010101000000000101
01010000000000000000000000000000000000000000000000000000000000000101
01010000000000000000000000000000000000000000000000000000000000000101
01010000000000000000000000000000000000000000000000000000000000000101
01010000000000000000000000000000000000000000000000000000000000000101
01010000000000000000000000000000000000000000000000000000000000000101
01010000000000000000000000000000000000000000000000000000000000000101
01010000000000000000000000000000000000000000000000000000000000000101
