"Level Thirteen"
10
50 40 60 80 90 94 99
1.0
music/pip-imadeamistake.it
sounds/click.ogg
sounds/touch.ogg
sounds/bomb.ogg
8
images/background.png
images/brick_dkgrey.svg
images/brick_blue.svg
images/brick_red.svg
images/brick_purple.svg
images/brick_orange.svg
images/brick_green.svg
images/brick_yellow.svg
01010101010101010101010101010101010101010101010101010101010101010101
01010700070007000700070007000700070007000700070007000700070007000101
01010200020002000200020002000200020002000200020002000200020002000101
01010300030003000300030003000300030003000300030003000300030003000101
01010400040004000400040004000400040004000400040004000400040004000101
01010500050005000500050005000500050005000500050005000500050005000101
01010101060006000600060006000600060006000600060006000600060001010101
01010000010107000700070007000700070007000700070007000700010100000101
01010000000001010200020002000200020002000200020002000101000000000101
01010000000000000101030003000300030003000300030001010000000000000101
01010000000000000000010104000400040004000400010100000000000000000101
01010000000000000000000001010502050305020101000000000000000000000101
01010000000000000000000000000000000000000000000000000000000000000101
01010000000000000000000000000000000000000000000000000000000000000101
01010000000000000000000000000000000000000000000000000000000000000101
01010000000000000000000000000000000000000000000000000000000000000101
01010000000000000000000000000000000000000000000000000000000000000101
01010000000000000000000000000000000000000000000000000000000000000101
01010000000000000000000000000000000000000000000000000000000000000101
01010000000000000000000000000000000000000000000000000000000000000101
