"Gems"
10
50 40 60 80 90 94 99
1.0
music/pip-majordisappointment.it
sounds/click.ogg
sounds/touch.ogg
sounds/bomb.ogg
8
images/background.png
images/brick_dkgrey.svg
images/brick_blue.svg
images/brick_red.svg
images/brick_purple.svg
images/brick_orange.svg
images/brick_green.svg
images/brick_yellow.svg
01010101010101010101010101010101010101010101010101010101010101010101
01010000000000000000000000000000000000000000000000000000000000000101
01010000020000000000000000000000010100000000000000000101000000000101
01010200030002000000000000000000000000000000020000000000000000000101
01010000020000000000000002000000000000000200030002000000000000000101
01010000000000000000020003000200000000000000020000000000020000000101
01010000000000000000000002000000000000000101000000000200030002000101
01010000000001010000000000000000000002000000000000000000020000000101
01010000000000000000000000000000020003000200000000000000000000000101
01010000000000000000000001010000000002000000000002000000000000000101
01010000000000000200000000000000000000000000020003000200000000000101
01010000000002000300020000000000000000000000000002000000000000000101
01010000000000000200000000000000040000000000000000000000010100000101
01010000010100000000000000000400050004000000010100000000000000000101
01010000000000000000000000000000040000000000000000000000000000000101
01010000000000000000000001010000000000000000000000000101000000000101
01010000000001010000000000000000000000000000000000000000000000000101
01010000000000000000000000000000000000000000000000000000000000000101
01010000000000000000000000000000000000000000000000000000000000000101
01010000000000000000000000000000000000000000000000000000000000000101