"Level Three"
10
50 40 60 80 90 94 99
1.0
music/pip-boilingdeals.it
sounds/click.ogg
sounds/touch.ogg
sounds/bomb.ogg
8
images/background.png
images/brick_dkgrey.svg
images/brick_blue.svg
images/brick_red.svg
images/brick_purple.svg
images/brick_orange.svg
images/brick_green.svg
images/brick_yellow.svg
01010101010101010101010101010101010101010101010101010101010101010101
01010000000000000000000000000000000000000000000000000000000000000101
01010000020003000200030002000300020003000200030002000300020000000101
01010000030002000300020003000200030002000300020003000200030000000101
01010000020003000200030002000300020003000200030002000300020000000101
01010000030002000300020003000200030002000300020003000200030000000101
01010000000000000000000000000000000000000000000000000000000000000101
01010000000000000000000000000000000000000000000000000000000000000101
01010000020003000200030002000300020003000200030002000300020000000101
01010000030002000300020003000200030002000300020003000200030000000101
01010000020003000200030002000300020003000200030002000300020000000101
01010000030002000300020003000200030002000300020003000200030000000101
01010000000000000000000000000000000000000000000000000000000000000101
01010000000000000000000000000000000000000000000000000000000000000101
01010000000000000000000000000000000000000000000000000000000000000101
01010000000000000000000000000000000000000000000000000000000000000101
01010000000000000000000000000000000000000000000000000000000000000101
01010000000000000000000000000000000000000000000000000000000000000101
01010000000000000000000000000000000000000000000000000000000000000101
01010000000000000000000000000000000000000000000000000000000000000101
