"Level Eleven - Just One!"
1000
50 40 60 80 90 94 99
1.5
music/pip-volcanic.it
sounds/click.ogg
sounds/touch.ogg
sounds/bomb.ogg
8
images/background.png
images/brick_dkgrey.svg
images/brick_blue.svg
images/brick_red.svg
images/brick_purple.svg
images/brick_orange.svg
images/brick_green.svg
images/brick_yellow.svg
01010101010101010101010101010101010101010101010101010101010101010101
01010000000000000000000000000000000000000000000000000000000000000101
01010000000000000000000000000000000000000000000000000000000000000101
01010000000000000000000000000000000000000000000000000000000000000101
01010000000000000000000000000000000000000000000000000000000000000101
01010000000001010282010100000000000000000000010104820101000000000101
01010000000001010101010100000000000000000000010101010101000000000101
01010000000000000000000000000000000000000000000000000000000000000101
01010000000000000000000000000000000000000000000000000000000000000101
01010000000000000000000000000000000000000000000000000000000000000101
01010000000000000000000000000000000000000000000000000000000000000101
01010000000001010382010100000000000000000000010105820101000000000101
01010000000001010101010100000000000000000000010101010101000000000101
01010000000000000000000000000000000000000000000000000000000000000101
01010000000000000000000000000000000000000000000000000000000000000101
01010000000000000000000000000000000000000000000000000000000000000101
01010000000000000000000000000000000000000000000000000000000000000101
01010000000000000000000000000000000000000000000000000000000000000101
01010000000000000000000000000000000000000000000000000000000000000101
01010000000000000000000000000000000000000000000000000000000000000101
