"Iron Man Rules"
100
50 40 60 80 90 94 99
1.8
music/pip-ursusignoramus.it
sounds/click.ogg
sounds/touch.ogg
sounds/bomb.ogg
8
images/background.png
images/brick_dkgrey.svg
images/brick_blue.svg
images/brick_red.svg
images/brick_purple.svg
images/brick_orange.svg
images/brick_fixed.svg
images/brick_yellow.svg
01010101010101010101010101010101010101010101010101010101010101010101
01010000000000000000000000000000000000000000000000000000000000000101
01010000000000000000000000000300030003000000000000000000000000000101
01010000000000000000000003000700030007000300000000000000000000000101
01010000000000000000030007000700070007000700030000000000000000000101
01010000000000000000030002000200070002000200030000000000000000000101
01010000000000000000030007000700070007000700030000000000000000000101
01010000000000000000030007000700070007000700030000000000000000000101
01010000000000000000030003000100010001000300030000000000000000000101
01010000000000000000000003000700070007000300000000000000000000000101
01010000000000000000000000000300030003000000000000000000000000000101
01010000000000000000000000000000000000000000000000000000000000000101
01010000000000000000000000000000000000000000000000000000000000000101
01010000000000000000000000000000000000000000000000000000000000000101
01010000000000000000000000000000000000000000000000000000000000000101
01010000000000000000000000000000000000000000000000000000000000000101
01010000000000000000000000000000000000000000000000000000000000000101
01010000000000000000000000000000000000000000000000000000000000000101
01010000000000000000000000000000000000000000000000000000000000000101
01010000000000000000000000000000000000000000000000000000000000000101
