"Verticals"
10
50 40 60 80 90 94 99
1.0
music/pip-tantrumsgalore.it
sounds/click.ogg
sounds/touch.ogg
sounds/bomb.ogg
6
images/background.png
images/brick_dkgrey.svg
images/brick_blue.svg
images/brick_red.svg
images/brick_purple.svg
images/brick_orange.svg
01010101010101010101010101010101010101010101010101010101010101010101
01010000000000000000000000000000000000000000000000000000000000000101
01010000000000000000000000000000000000000000000000000000000000000101
01010000020002000200020001010200020002000101020002000200020000000101
01010000030003000300030001010300030003000101030003000300030000000101
01010000040004000400040001010400040004000101040004000400040000000101
01010000050005000500050001010500050005000101050005000500050000000101
01010000000000000000000000000000000000000000000000000000000000000101
01010000020002000200020001010200020002000101020002000200020000000101
01010000030003000300030001010300030003000101030003000300030000000101
01010000040004000400040001010400040004000101040004000400040000000101
01010000050005000500050001010500050005000101050005000500050000000101
01010000000000000000000000000000000000000000000000000000000000000101
01010000000000000000000000000000000000000000000000000000000000000101
01010000000000000000000000000000000000000000000000000000000000000101
01010000000000000000000000000000000000000000000000000000000000000101
01010000000000000000000000000000000000000000000000000000000000000101
01010000000000000000000000000000000000000000000000000000000000000101
01010000000000000000000000000000000000000000000000000000000000000101
01010000000000000000000000000000000000000000000000000000000000000101
