"Level Twenty"
100
50 40 60 80 90 94 99
1.75
music/pip-winterinpipia.it
sounds/click.ogg
sounds/touch.ogg
sounds/bomb.ogg
8
images/background.png
images/brick_dkgrey.svg
images/brick_blue.svg
images/brick_red.svg
images/brick_purple.svg
images/brick_orange.svg
images/brick_green.svg
images/brick_yellow.svg
01010101010101010101010101010101010101010101010101010101010101010101
01010000000007000000000000000000000000000000000000000000000006000101
01010000000000000000040000000000010200000000000000000102000000000101
01010000010502000000000000000000000000000000040000000700000000000101
01010000000000000000030000000000000006000000000000000000000000000101
01010000070000000000010500000000000000000000000000000000000000000101
01010000000000000000000000000000040000000103000000000000030000000101
01010000000001040000000000000700000002000000000005000000000000000101
01010000000000000000060000000000000000000000000001020000000000000101
01010000000000000000000001040000000001050000000000000000000000000101
01010000000000000000000000000300000000000000030000000000000005000101
01010000000002000000010300000000000000000000000000000000000000000101
01010000000000000000000000000000000006000000000000000000010400000101
01010000010200000300000002000105000000000000010300000000000000000101
01010000000000000000000000000000000000000000000000000000000000000101
01010000000000000000040000000300000007000000000000000105000000000101
01010000000001050000000000000000000001050000000000000400000000000101
01010000000000000000000000000000000000000000000000000000000000000101
01010000000000000000000000000000000000000000000000000000000000000101
01010000000000000000000000000000000000000000000000000000000000000101