"Level Eightteen"
10
50 40 60 80 90 94 99
1.0
music/pip-spindlydeals.it
sounds/click.ogg
sounds/touch.ogg
sounds/bomb.ogg
8
images/background.png
images/brick_dkgrey.svg
images/brick_blue.svg
images/brick_red.svg
images/brick_purple.svg
images/brick_orange.svg
images/brick_green.svg
images/brick_yellow.svg
01010101010101010101010101010101010101010101010101010101010101010101
01010000000000000000000000000000000000000000000000000000000002000101
01010000000000000000000000000000000000000000000000000000030003000101
01010000000000000000000000000000000000000000000000000400040004000101
01010000000000000000000000000000000000000000000005000500050005000101
01010000000000000000000000000000000000000000060006000600060006000101
01010000000000000000000000000000000000000700070007000700070007000101
01010000000000000000000000000000000002000200020002000200020002000101
01010000000000000000000000000000030003000300030003000300030003000101
01010000000000000000000000000400040004000400040004000400040004000101
01010000000000000000000005000500050005000500050005000500050005000101
01010000000000000000060006000600060006000600060006000600060006000101
01010000000000000101010101010101010101010101010101010101010101010101
01010000000000000000000000000000000000000000000000000000000000000101
01010000000000000000000000000000000000000000000000000000000000000101
01010000000000000000000000000000000000000000000000000000000000000101
01010000000000000000000000000000000000000000000000000000000000000101
01010000000000000000000000000000000000000000000000000000000000000101
01010000000000000000000000000000000000000000000000000000000000000101
01010000000000000000000000000000000000000000000000000000000000000101